bcm_brca_transcriptomics	bcm_brca_BRCA-gene_RSEM_tumor_normal_UQ_log2(x+1)_BCM.txt
bcm_brca_mapping	bcm_brca_gencode.v34.basic.annotation-mapping.txt
bcm_ccrcc_circular_RNA	bcm_ccrcc_CCRCC-circRNA_rsem_tumor_normal_UQ_log2(x+1)_BCM.txt
bcm_ccrcc_transcriptomics	bcm_ccrcc_CCRCC-gene_rsem_removed_circRNA_tumor_normal_UQ_log2(x+1)_BCM.txt
bcm_ccrcc_mapping	bcm_ccrcc_gencode.v34.basic.annotation-mapping.txt
bcm_coad_transcriptomics	bcm_coad_CRC-gene_RSEM_tumor_normal_UQ_log2(x+1)_BCM.txt
bcm_coad_mapping	bcm_coad_gencode.v34.basic.annotation-mapping.txt
bcm_gbm_circular_RNA	bcm_gbm_GBM-circRNA_rsem_tumor_normal_UQ_log2(x+1)_BCM.txt
bcm_gbm_transcriptomics	bcm_gbm_GBM-gene_rsem_removed_circRNA_tumor_normal_UQ_log2(x+1)_BCM.txt
bcm_gbm_mapping	bcm_gbm_gencode.v34.basic.annotation-mapping.txt
bcm_hnscc_circular_RNA	bcm_hnscc_HNSCC-circRNA_rsem_tumor_normal_UQ_log2(x+1)_BCM.txt
bcm_hnscc_transcriptomics	bcm_hnscc_HNSCC-gene_rsem_removed_circRNA_tumor_normal_UQ_log2(x+1)_BCM.txt
bcm_hnscc_mapping	bcm_hnscc_gencode.v34.basic.annotation-mapping.txt
bcm_lscc_circular_RNA	bcm_lscc_LSCC-circRNA_rsem_tumor_normal_UQ_log2(x+1)_BCM.txt
bcm_lscc_transcriptomics	bcm_lscc_LSCC-gene_rsem_removed_circRNA_tumor_normal_UQ_log2(x+1)_BCM.txt
bcm_lscc_mapping	bcm_lscc_gencode.v34.basic.annotation-mapping.txt
bcm_luad_circular_RNA	bcm_luad_LUAD-circRNA_rsem_tumor_normal_UQ_log2(x+1)_BCM.txt
bcm_luad_transcriptomics	bcm_luad_LUAD-gene_rsem_removed_circRNA_tumor_normal_UQ_log2(x+1)_BCM.txt
bcm_luad_mapping	bcm_luad_gencode.v34.basic.annotation-mapping.txt
bcm_ov_transcriptomics	bcm_ov_OV-gene_RSEM_tumor_normal_UQ_log2(x+1)_BCM.txt
bcm_ov_mapping	bcm_ov_gencode.v34.basic.annotation-mapping.txt
bcm_pdac_circular_RNA	bcm_pdac_PDAC-circRNA_rsem_tumor_normal_UQ_log2(x+1)_BCM.txt
bcm_pdac_transcriptomics	bcm_pdac_PDAC-gene_rsem_removed_circRNA_tumor_normal_UQ_log2(x+1)_BCM.txt
bcm_pdac_mapping	bcm_pdac_gencode.v34.basic.annotation-mapping.txt
bcm_ucec_circular_RNA	bcm_ucec_UCEC-circRNA_rsem_tumor_normal_UQ_log2(x+1)_BCM.txt
bcm_ucec_transcriptomics	bcm_ucec_UCEC-gene_rsem_removed_circRNA_tumor_normal_UQ_log2(x+1)_BCM.txt
bcm_ucec_mapping	bcm_ucec_gencode.v34.basic.annotation-mapping.txt
broad_brca_transcriptomics	broad_brca_BRCA.rsem_transcripts_tpm.txt.gz
broad_brca_mapping	broad_brca_sample_descriptions.tsv
broad_brca_mapping	broad_brca_gencode.v34.GRCh38.genes.collapsed_only.gtf
broad_ccrcc_mapping	broad_ccrcc_sample_descriptions.tsv
broad_ccrcc_mapping	broad_ccrcc_gencode.v34.GRCh38.genes.collapsed_only.gtf
broad_ccrcc_transcriptomics	broad_ccrcc_CCRCC.rsem_transcripts_tpm.txt.gz
broad_coad_mapping	broad_coad_sample_descriptions.tsv
broad_coad_mapping	broad_coad_gencode.v34.GRCh38.genes.collapsed_only.gtf
broad_coad_transcriptomics	broad_coad_Colon.rsem_transcripts_tpm.txt.gz
broad_gbm_mapping	broad_gbm_sample_descriptions.tsv
broad_gbm_mapping	broad_gbm_gencode.v34.GRCh38.genes.collapsed_only.gtf
broad_gbm_transcriptomics	broad_gbm_GBM.rsem_transcripts_tpm.txt.gz
broad_hnscc_mapping	broad_hnscc_sample_descriptions.tsv
broad_hnscc_mapping	broad_hnscc_gencode.v34.GRCh38.genes.collapsed_only.gtf
broad_hnscc_transcriptomics	broad_hnscc_HNSCC.rsem_transcripts_tpm.txt.gz
broad_lscc_mapping	broad_lscc_sample_descriptions.tsv
broad_lscc_mapping	broad_lscc_gencode.v34.GRCh38.genes.collapsed_only.gtf
broad_lscc_transcriptomics	broad_lscc_LSCC.rsem_transcripts_tpm.txt.gz
broad_luad_mapping	broad_luad_sample_descriptions.tsv
broad_luad_mapping	broad_luad_gencode.v34.GRCh38.genes.collapsed_only.gtf
broad_luad_transcriptomics	broad_luad_LUAD.rsem_transcripts_tpm.txt.gz
broad_luad_mapping	broad_luad_aliquot_to_patient_ID.tsv
broad_ov_mapping	broad_ov_sample_descriptions.tsv
broad_ov_mapping	broad_ov_gencode.v34.GRCh38.genes.collapsed_only.gtf
broad_ov_transcriptomics	broad_ov_Ovary.rsem_transcripts_tpm.txt.gz
broad_pdac_transcriptomics	broad_pdac_PDAC.rsem_transcripts_tpm.txt.gz
broad_pdac_mapping	broad_pdac_sample_descriptions.tsv
broad_pdac_mapping	broad_pdac_gencode.v34.GRCh38.genes.collapsed_only.gtf
broad_ucec_mapping	broad_ucec_sample_descriptions.tsv
broad_ucec_mapping	broad_ucec_gencode.v34.GRCh38.genes.collapsed_only.gtf
broad_ucec_transcriptomics	broad_ucec_UCEC.rsem_transcripts_tpm.txt.gz
broad_ucec_mapping	broad_ucec_aliquot_to_patient_ID.tsv
harmonized_somatic_mutation	harmonized_PanCan_Union_Maf_Broad_WashU.maf
mssm_clinical	mssm_clinical_Pan-cancer.Dec2020.tsv
umich_brca_phosphoproteomics	umich_brca_Report_abundance_groupby=multi-site_protNorm=MD_gu=2.tsv
umich_brca_proteomics	umich_brca_Report_abundance_groupby=protein_protNorm=MD_gu=2.tsv
umich_brca_mapping	umich_brca_prosp-brca-all-samples.txt
umich_ccrcc_phosphoproteomics	umich_ccrcc_Report_abundance_groupby=multi-site_protNorm=MD_gu=2.tsv
umich_ccrcc_proteomics	umich_ccrcc_Report_abundance_groupby=protein_protNorm=MD_gu=2.tsv
umich_ccrcc_mapping	umich_ccrcc_aliquot_to_patient_ID.tsv
umich_coad_phosphoproteomics	umich_coad_Report_abundance_groupby=multi-site_protNorm=MD_gu=2.tsv
umich_coad_proteomics	umich_coad_Report_abundance_groupby=protein_protNorm=MD_gu=2.tsv
umich_coad_mapping	umich_coad_CRC_Prospective sample info.xlsx
umich_coad_phosphoproteomics	umich_coad_Report_abundance_groupby=multi-site_protNorm=MD_gu=2.tsv
umich_coad_proteomics	umich_coad_Report_abundance_groupby=protein_protNorm=MD_gu=2.tsv
umich_coad_mapping	umich_coad_CRC_Prospective sample info.xlsx
umich_gbm_phosphoproteomics	umich_gbm_Report_abundance_groupby=multi-site_protNorm=MD_gu=2.tsv
umich_gbm_proteomics	umich_gbm_Report_abundance_groupby=protein_protNorm=MD_gu=2.tsv
umich_gbm_mapping	umich_gbm_aliquot_to_patient_ID.tsv
umich_hnscc_phosphoproteomics	umich_hnscc_Report_abundance_groupby=multi-site_protNorm=MD_gu=2.tsv
umich_hnscc_proteomics	umich_hnscc_Report_abundance_groupby=protein_protNorm=MD_gu=2.tsv
umich_lscc_phosphoproteomics	umich_lscc_Report_abundance_groupby=multi-site_protNorm=MD_gu=2.tsv
umich_lscc_proteomics	umich_lscc_Report_abundance_groupby=protein_protNorm=MD_gu=2.tsv
umich_lscc_mapping	umich_lscc_aliquot_to_patient_ID.tsv
umich_luad_phosphoproteomics	umich_luad_Report_abundance_groupby=multi-site_protNorm=MD_gu=2.tsv
umich_luad_proteomics	umich_luad_Report_abundance_groupby=protein_protNorm=MD_gu=2.tsv
umich_luad_mapping	umich_luad_aliquot_to_patient_ID.tsv
umich_ov_phosphoproteomics	umich_ov_Report_abundance_groupby=multi-site_protNorm=MD_gu=2.tsv
umich_ov_proteomics	umich_ov_Report_abundance_groupby=protein_protNorm=MD_gu=2.tsv
umich_ov_mapping	umich_ov_OV_sample_TMT_annotation_UMich_GENCODE34_0315.csv
umich_ov_phosphoproteomics	umich_ov_Report_abundance_groupby=multi-site_protNorm=MD_gu=2.tsv
umich_ov_proteomics	umich_ov_Report_abundance_groupby=protein_protNorm=MD_gu=2.tsv
umich_ov_mapping	umich_ov_OV_sample_TMT_annotation_UMich_GENCODE34_0315.csv
umich_pdac_phosphoproteomics	umich_pdac_Report_abundance_groupby=multi-site_protNorm=MD_gu=2.tsv
umich_pdac_proteomics	umich_pdac_Report_abundance_groupby=protein_protNorm=MD_gu=2.tsv
umich_pdac_mapping	umich_pdac_aliquot_to_patient_ID.tsv
umich_ucec_phosphoproteomics	umich_ucec_Report_abundance_groupby=multi-site_protNorm=MD_gu=2.tsv
umich_ucec_proteomics	umich_ucec_Report_abundance_groupby=protein_protNorm=MD_gu=2.tsv
umich_ucec_mapping	umich_ucec_aliquot_to_patient_ID.tsv
washu_brca_somatic_mutation	washu_brca_BR_prospective.dnp.annotated.exonic.addrecovercases.maf.gz
washu_brca_transcriptomics	washu_brca_BR_tumor_RNA-Seq_Expr_WashU_FPKM.tsv.gz
washu_brca_xcell	washu_brca_BR_xCell.txt
washu_brca_cibersort	washu_brca_CIBERSORT.Output_Abs_BR.txt
washu_brca_mapping	washu_brca_gencode.v22.annotation.gtf.gz
washu_brca_CNV	washu_brca_BR.gene_level.from_seg.filtered.tsv
washu_brca_tumor_purity	washu_brca_CPTAC_pancan_RNA_tumor_purity_ESTIMATE_WashU.tsv.gz
washu_ccrcc_transcriptomics	washu_ccrcc_ccRCC_NAT_RNA-Seq_Expr_WashU_FPKM.tsv.gz
washu_ccrcc_somatic_mutation	washu_ccrcc_ccRCC_discovery.dnp.annotated.exonic.maf.gz
washu_ccrcc_transcriptomics	washu_ccrcc_ccRCC_tumor_RNA-Seq_Expr_WashU_FPKM.tsv.gz
washu_ccrcc_miRNA	washu_ccrcc_ccRCC_mature_miRNA_combined.tsv
washu_ccrcc_miRNA	washu_ccrcc_ccRCC_precursor_miRNA_combined.tsv
washu_ccrcc_miRNA	washu_ccrcc_ccRCC_total_miRNA_combined.tsv
washu_ccrcc_cibersort	washu_ccrcc_CIBERSORT.Output_Abs_ccRCC.txt
washu_ccrcc_xcell	washu_ccrcc_ccRCC_xCell.txt
washu_ccrcc_mapping	washu_ccrcc_gencode.v22.annotation.gtf.gz
washu_ccrcc_CNV	washu_ccrcc_ccRCC.gene_level.from_seg.filtered.tsv
washu_ccrcc_tumor_purity	washu_ccrcc_CPTAC_pancan_RNA_tumor_purity_ESTIMATE_WashU.tsv.gz
washu_coad_somatic_mutation	washu_coad_CO_prospective.dnp.annotated.exonic.addrecovercases.maf.gz
washu_coad_transcriptomics	washu_coad_CO_tumor_RNA-Seq_Expr_WashU_FPKM.tsv.gz
washu_coad_xcell	washu_coad_CO_xCell.txt
washu_coad_cibersort	washu_coad_CIBERSORT.Output_Abs_CO.txt
washu_coad_CNV	washu_coad_CO.gene_level.from_seg.filtered.tsv
washu_coad_mapping	washu_coad_gencode.v22.annotation.gtf.gz
washu_coad_tumor_purity	washu_coad_CPTAC_pancan_RNA_tumor_purity_ESTIMATE_WashU.tsv.gz
washu_gbm_somatic_mutation	washu_gbm_GBM_discovery.dnp.annotated.exonic.maf.gz
washu_gbm_transcriptomics	washu_gbm_GBM_tumor_RNA-Seq_Expr_WashU_FPKM.tsv.gz
washu_gbm_miRNA	washu_gbm_GBM_mature_miRNA_combined.tsv
washu_gbm_miRNA	washu_gbm_GBM_precursor_miRNA_combined.tsv
washu_gbm_miRNA	washu_gbm_GBM_total_miRNA_combined.tsv
washu_gbm_xcell	washu_gbm_GBM_xCell.txt
washu_gbm_cibersort	washu_gbm_CIBERSORT.Output_Abs_GBM.txt
washu_gbm_tumor_purity	washu_gbm_CPTAC_pancan_RNA_tumor_purity_ESTIMATE_WashU.tsv.gz
washu_gbm_CNV	washu_gbm_GBM.gene_level.from_seg.filtered.tsv
washu_gbm_mapping	washu_gbm_gencode.v22.annotation.gtf.gz
washu_hnscc_transcriptomics	washu_hnscc_HNSCC_NAT_RNA-Seq_Expr_WashU_FPKM.tsv.gz
washu_hnscc_somatic_mutation	washu_hnscc_HNSCC_discovery.dnp.annotated.exonic.maf.gz
washu_hnscc_transcriptomics	washu_hnscc_HNSCC_tumor_RNA-Seq_Expr_WashU_FPKM.tsv.gz
washu_hnscc_miRNA	washu_hnscc_HNSCC_mature_miRNA_combined.tsv
washu_hnscc_miRNA	washu_hnscc_HNSCC_precursor_miRNA_combined.tsv
washu_hnscc_miRNA	washu_hnscc_HNSCC_total_miRNA_combined.tsv
washu_hnscc_xcell	washu_hnscc_HNSCC_xCell.txt
washu_hnscc_cibersort	washu_hnscc_CIBERSORT.Output_Abs_HNSCC.txt
washu_hnscc_tumor_purity	washu_hnscc_CPTAC_pancan_RNA_tumor_purity_ESTIMATE_WashU.tsv.gz
washu_hnscc_mapping	washu_hnscc_gencode.v22.annotation.gtf.gz
washu_hnscc_CNV	washu_hnscc_HNSCC.gene_level.from_seg.filtered.tsv
washu_lscc_transcriptomics	washu_lscc_LSCC_NAT_RNA-Seq_Expr_WashU_FPKM.tsv.gz
washu_lscc_somatic_mutation	washu_lscc_LSCC_discovery.dnp.annotated.exonic.maf.gz
washu_lscc_transcriptomics	washu_lscc_LSCC_tumor_RNA-Seq_Expr_WashU_FPKM.tsv.gz
washu_lscc_miRNA	washu_lscc_LSCC_mature_miRNA_combined.tsv
washu_lscc_miRNA	washu_lscc_LSCC_precursor_miRNA_combined.tsv
washu_lscc_miRNA	washu_lscc_LSCC_total_miRNA_combined.tsv
washu_lscc_xcell	washu_lscc_LSCC_xCell.txt
washu_lscc_cibersort	washu_lscc_CIBERSORT.Output_Abs_LSCC.txt
washu_lscc_mapping	washu_lscc_gencode.v22.annotation.gtf.gz
washu_lscc_CNV	washu_lscc_LSCC.gene_level.from_seg.filtered.tsv
washu_lscc_tumor_purity	washu_lscc_CPTAC_pancan_RNA_tumor_purity_ESTIMATE_WashU.tsv.gz
washu_luad_transcriptomics	washu_luad_LUAD_NAT_RNA-Seq_Expr_WashU_FPKM.tsv.gz
washu_luad_somatic_mutation	washu_luad_LUAD_discovery.dnp.annotated.exonic.maf.gz
washu_luad_transcriptomics	washu_luad_LUAD_tumor_RNA-Seq_Expr_WashU_FPKM.tsv.gz
washu_luad_miRNA	washu_luad_LUAD_mature_miRNA_combined.tsv
washu_luad_miRNA	washu_luad_LUAD_precursor_miRNA_combined.tsv
washu_luad_miRNA	washu_luad_LUAD_total_miRNA_combined.tsv
washu_luad_xcell	washu_luad_LUAD_xCell.txt
washu_luad_cibersort	washu_luad_CIBERSORT.Output_Abs_LUAD.txt
washu_luad_mapping	washu_luad_gencode.v22.annotation.gtf.gz
washu_luad_CNV	washu_luad_LUAD.gene_level.from_seg.filtered.tsv
washu_luad_tumor_purity	washu_luad_CPTAC_pancan_RNA_tumor_purity_ESTIMATE_WashU.tsv.gz
washu_ov_somatic_mutation	washu_ov_OV_prospective.dnp.annotated.exonic.addrecovercases.maf.gz
washu_ov_transcriptomics	washu_ov_OV_tumor_RNA-Seq_Expr_WashU_FPKM.tsv.gz
washu_ov_xcell	washu_ov_OV_xCell.txt
washu_ov_cibersort	washu_ov_CIBERSORT.Output_Abs_OV.txt
washu_ov_CNV	washu_ov_OV.gene_level.from_seg.filtered.tsv
washu_ov_mapping	washu_ov_gencode.v22.annotation.gtf.gz
washu_ov_tumor_purity	washu_ov_CPTAC_pancan_RNA_tumor_purity_ESTIMATE_WashU.tsv.gz
washu_pdac_transcriptomics	washu_pdac_PDA_NAT_RNA-Seq_Expr_WashU_FPKM.tsv.gz
washu_pdac_transcriptomics	washu_pdac_PDA_tumor_RNA-Seq_Expr_WashU_FPKM.tsv.gz
washu_pdac_somatic_mutation	washu_pdac_PDA_discovery.dnp.annotated.exonic.maf.gz
washu_pdac_miRNA	washu_pdac_PDA_precursor_miRNA_combined.tsv
washu_pdac_miRNA	washu_pdac_PDA_total_miRNA_combined.tsv
washu_pdac_miRNA	washu_pdac_PDA_mature_miRNA_combined.tsv
washu_pdac_CNV	washu_pdac_PDA.gene_level.from_seg.filtered.tsv
washu_pdac_mapping	washu_pdac_gencode.v22.annotation.gtf.gz
washu_pdac_tumor_purity	washu_pdac_CPTAC_pancan_RNA_tumor_purity_ESTIMATE_WashU.tsv.gz
washu_pdac_xcell	washu_pdac_PDA_xCell.txt
washu_pdac_cibersort	washu_pdac_CIBERSORT.Output_Abs_PDA.txt
washu_ucec_transcriptomics	washu_ucec_EC_NAT_RNA-Seq_Expr_WashU_FPKM.tsv.gz
washu_ucec_somatic_mutation	washu_ucec_EC_discovery.dnp.annotated.exonic.maf.gz
washu_ucec_transcriptomics	washu_ucec_EC_tumor_RNA-Seq_Expr_WashU_FPKM.tsv.gz
washu_ucec_miRNA	washu_ucec_EC_mature_miRNA_combined.tsv
washu_ucec_miRNA	washu_ucec_EC_precursor_miRNA_combined.tsv
washu_ucec_miRNA	washu_ucec_EC_total_miRNA_combined.tsv
washu_ucec_xcell	washu_ucec_EC_xCell.txt
washu_ucec_cibersort	washu_ucec_CIBERSORT.Output_Abs_EC.txt
washu_ucec_mapping	washu_ucec_gencode.v22.annotation.gtf.gz
washu_ucec_CNV	washu_ucec_UCEC.gene_level.from_seg.filtered.tsv
washu_ucec_tumor_purity	washu_ucec_CPTAC_pancan_RNA_tumor_purity_ESTIMATE_WashU.tsv.gz
